F 71,19,0000021



NO 	 	./textures/bluestone.xpm




		 	 	 	SO ./textures/greystone.xpm
WE 	./textures/eagle.xpm
EA ./textures/redbrick.xpm


			   C 65,240,255









111111111111111
11000E00011111
11000000000001111111111
11000000000000001111111111111
1100000000000000011
11111111111111111111111111111
11111111111111111111111111
110000000000000000000000011111
1111111111111111111111111111
11111111111111111111111111