F 71,19,0000021



NO 	 	./textures/bluestone.xpm




		 	 	 	SO ./textures/greystone.xpm
WE 	./textures/eagle.xpm
EA ./textures/redbrick.xpm


			   C 65,240,255









111111111111111
11000000011111
111111111111111111111111111111111111111111111111111111111111111111111111111
111111111111111111111111111111111111111111111111111111111111111111111111111
1100000000000000000000000000000000000000000000111
100000000000000000000000000000000000000000111111
11000000000000E00000000000000000000000000000011111111111111111111111111111111
11100000000000000000000000000000000000000000011111111111111111111111111111111111
110000000000000000000000000000000000000000111111111
111111111111111111111111111111111111111111111111111111111111111111111111111
11111111111111111111111111111111111111111111
111111111111111111111111111111111111111111111111111111111111111111111111111
11111111111111111111111111111111111111111111
1111111111111111111111111111111111111111111111111111111111111111111111111111
11111111111111111111111111111111111111111111