F 5,200, 2



NO 	 	./textures/bluestone.xpm




		 	 	 	SO ./textures/greystone.xpm
WE 	./textures/eagle.xpm
EA ./textures/redbrick.xpm


			   C 65,65,    250








111111111111111
1100000011111
1100000000S001111111111
11000000000000001111111111111
1100000000000000011
11100000111000000111111
11100000001000011111111111
110000000000000000000000011111      
11110000111111111111111111111    
1111001100111111111111111111     
111100011111
11000000111111
11000000000001111111111
11000000000000001111111111111
1100000000000000011
11111111111111111111111111111
11111111111111111111111111
110000000000000000000000011111
1111111111111111111111111111
11111111111111111111111111
11111111111111111111111111111
11111111111111111111111111
110000000000000000000000011111
1111111111111111111111111111
11111111111111111111111111