F 50, 50, 100



NO 	 	./textures/bluestone.xpm




		 	 	 	SO ./textures/greystone.xpm
WE 	./textures/eagle.xpm
EA ./textures/redbrick.xpm

			   C 80, 80, 130






1
1
11111111111111111111111111111111111
100000000010000000000000000000E0001 
1000000001D1000000000000000000000001  1
100000111000000000000000000000000001
100000DDD0000000000000010000000000001    
100000111000000000000010000001000011
100000000000000000000000000000000001
1000000000000000000000000000000000001
1111D11111000001111111111111111111111
1111D11111111110111111							1
111111111110000000000011						 	1
111111111111111111111111							1
