
F 71,19,00000210



NO 	 	./textures/bluestone.xpm

		 	 	 	SO ./textures/redbrick.xpm
WE 	./textures/eagle.xpm
EA ./textures/redbrick.xpm


			   C 65,240,250




11111111111111111111111111111111111111111111111111111
10000000000000000000000000000000000000000000000000001
100000000000000000000000000000000E0000000000000000001
10000000000000000000000000000000000000000000000000001
10000000000000000000000000000000000000000000000000001
10000000000000000000000000000000000000000000000000001
11111111111111111111111111111111111111111111111111111
11111111111111111111111111111111111111111111111111111
11111111111111111111111111111111111111111111111111111
11111111111111111111111111111111111111111111111111111
11111111111111111111111111111111111111111111111111111
11111111111111111111111111111111111111111111111111111
11111111111111111111111111111111111111111111111111111
11111111111111111111111111111111111111111111111111111
11111111111111111111111111111111111111111111111111111
11111111111111111111111111111111111111111111111111111
11111111111111111111111111111111111111111111111111111
11111111111111111111111111111111111111111111111111111
11111111111111111111111111111111111111111111111111111
11111111111111111111111111111111111111111111111111111
11111111111111111111111111111111111111111111111111111
11111111111111111111111111111111111111111111111111111
11111111111111111111111111111111111111111111111111111
11111111111111111111111111111111111111111111111111111
11111111111111111111111111111111111111111111111111111
11111111111111111111111111111111111111111111111111111
11111111111111111111111111111111111111111111111111111
11111111111111111111111111111111111111111111111111111
11111111111111111111111111111111111111111111111111111
11111111111111111111111111111111111111111111111111111
11111111111111111111111111111111111111111111111111111
11111111111111111111111111111111111111111111111111111
11111111111111111111111111111111111111111111111111111
11111111111111111111111111111111111111111111111111111
