
F 60,60,70


NO 	 	./textures/bluestone.xpm

		 	 	 	SO ./textures/redbrick.xpm
WE 	./textures/eagle.xpm
EA ./textures/redbrick.xpm


C 70,80,100


1111
1001
11011111111111111111111111111111
1000000000000000000000000000001
1000000000011100000000000000001
10000100000000E0000000000000001
1000100001110000100000000000001
1000000000000000100000000000001
1111111111111111111111111111111
1111111111111111111111111111111
1111111111111111111111111111111
1111111111111111111111111111111
1111111111111111111111111111111
1111111111111111111111111111111
1111111111111111111111111111111
1111111111111111111111111111111
1111111111111111111111111111111
1111111111111111111111111111111
1111111111111111111111111111111
1111111111111111111111111111111
1111111111111111111111111111111
1111111111111111111111111111111
