
F 71,19,00000210



NO 	 	./textures/bluestone.xpm

		 	 	 	SO ./textures/redbrick.xpm
WE 	./textures/eagle.xpm
EA ./textures/redbrick.xpm


			   C 65,240,250




    1111111111111111111
        100000100000001
        111111011111111111111 111
        100000010000100000000100001
        1000001000010000000000001
        10000011000010000000010001
        11101111111011111111110001
        110000110000001      10001
        100000010000001     10001
        100000010000001      10001  
        10000000000000111111111011111111111
        10000001000000100000000000000000001111111111111111111111
        100000010000001000000000000000000011111                1
        1100001100000010011100000000W00110010000001            1
        111111111111111001000000000000010010001                1
                      100000000000000000010001111111111111111111
                      1000000000000000000010001
                      100000000000000000000011
111111111111111111111111111111111111111111111111111111111111111111111111111111111
111111111111111111111111111111111111111111111111111111111111111111111111111111111
111111111111111111111111111111111111111111111111111111111111111111111111111111111
111111111111111111111111111111111111111111111111111111111111111111111111111111111
111111111111111111111111111111111111111111111111111111111111111111111111111111111
111111111111111111111111111111111111111111111111111111111111111111111111111111111
111111111111111111111111111111111111111111111111111111111111111111111111111111111
111111111111111111111111111111111111111111111111111111111111111111111111111111111
111111111111111111111111111111111111111111111111111111111111111111111111111111111
111111111111111111111111111111111111111111111111111111111111111111111111111111111
111111111111111111111111111111111111111111111111111111111111111111111111111111111
111111111111111111111111111111111111111111111111111111111111111111111111111111111
111111111111111111111111111111111111111111111111111111111111111111111111111111111