F 71,19,0000021



NO 	 	./textures/bluestone.xpm




		 	 	 	SO ./textures/greystone.xpm
WE 	./textures/eagle.xpm
EA ./textures/redbrick.xpm

			   C 65,240,255;






1
1
11111111111111111111111111111111111
10000000001000000000000000000000001 
1000000001D1000000000000000000000001  1
1000000111000000000000000000000000001
10000E0DDD000000000000000000000000001    
100000011100000000000000000000000001
100000000000000000000000000000000001
1000000000000000000000000000000000001
1111D1111111111111111111111111111111
1111D111111							1
10000011						1	1
1111111111							1
